 --- --- --- --- --- --- --- --- --- 
|           |                       |
     ---         --- --- --- ---     
|       |   |                       |
 ---             --- --- --- ---     
| >     |       | x                 |
 ---             --- --- --- ---     
|       |   |                       |
     ---         --- --- --- ---     
|           |                       |
 --- --- --- --- --- --- --- --- --- 
