 --- --- --- --- --- --- --- --- --- 
|                                 < |
     --- --- ---         --- ---     
|   |                   |           |
                 --- ---             
|   |       |                   |   |
         --- ---     ---             
|     x         |               |   |
     --- ---     --- --- ---         
|                                   |
 --- --- --- --- --- --- --- --- --- 