 --- --- --- --- --- --- --- --- --- 
|           |               |       |
     ---                             
|       |   |       |       |   | ^ |
 ---             --- ---         --- 
|       |       | x         |       |
     --- --- --- --- --- --- ---     
|   |       |       |       |       |
                                     
|       |       |       |           |
 --- --- --- --- --- --- --- --- --- 