 --- --- --- --- --- --- --- --- --- 
|       |               |           |
                                     
|   |       |                   |   |
     --- --- --- --- --- --- ---     
|               |               |   |
 ---     ---         ---             
|       |       |       |       | v |
     ---     --- ---             --- 
|                       |         x |
 --- --- --- --- --- --- --- --- --- 