 --- --- --- --- --- --- --- --- --- 
| >         |                       |
 --- ---                             
|           |           |           |
         ---     --- --- --- ---     
|       |       | x     |           |
     ---                             
|       |       |       |           |
                                     
|               |                   |
 --- --- --- --- --- --- --- --- --- 