 --- --- --- --- --- --- --- --- --- 
| ^             |                   |
     ---                             
|           |                       |
 ---             ---                 
|       |   |   | x |               |
         ---     --- --- ---         
|   |                   |           |
         ---         ---     ---     
|   |           |           |       |
 --- --- --- --- --- --- --- --- --- 