 --- --- --- --- --- --- --- --- --- 
| v |   |           |           |   |
     ---     ---         ---     --- 
|           |   |       |   |       |
 ---     --- --- --- --- --- ---     
|   |           |       |   |   |   |
 --- ---         --- ---     ---     
|   |   |       |   |   |   |   |   |
     --- --- --- --- --- --- ---     
|       |   |   | x                 |
 --- --- --- --- --- --- --- --- --- 