 --- --- --- --- --- --- --- --- --- 
| ^                                 |
                                     
|                                   |
                                     
|                 x                 |
                                     
|                                   |
                                     
|                                   |
 --- --- --- --- --- --- --- --- --- 