 --- --- --- --- --- --- --- --- --- 
| v |   |   |   |   |   |   |   |   |
 --- --- --- --- --- --- --- --- --- 
|   |   |   |   |   |   |   |   |   |
 --- --- --- --- --- --- --- --- --- 
|   |   |   |   | x |   |   |   |   |
 --- --- --- --- --- --- --- --- --- 
|   |   |   |   |   |   |   |   |   |
 --- --- --- --- --- --- --- --- --- 
|   |   |   |   |   |   |   |   |   |
 --- --- --- --- --- --- --- --- --- 