 --- --- --- --- --- --- --- --- --- 
|           |       |           |   |
     ---                 ---         
|       |   |   |       |   |       |
 ---             --- ---     ---     
|     < |   |           |       |   |
     ---     --- ---     ---         
|       |   |       |   |           |
 ---                         ---     
|       |       |       |   | x     |
 --- --- --- --- --- --- --- --- --- 
