 --- --- --- --- --- --- --- --- --- 
| <                                 |
     ---     ---     ---     ---     
|                                   |
     ---     ---     ---     ---     
|                                   |
     ---     ---     ---     ---     
|                                   |
     ---     ---     ---     ---     
|                                 x |
 --- --- --- --- --- --- --- --- --- 
