 --- --- --- --- --- --- --- --- --- 
| x             |                   |
     ---                 ---         
|           |           | ^ |       |
 ---             --- ---     ---     
|       |   |   |                   |
         ---     --- --- ---         
|   |                   |           |
         ---         ---     ---     
|   |           |           |       |
 --- --- --- --- --- --- --- --- --- 