 --- --- --- --- --- --- --- --- --- 
|               |                   |
     ---                 ---         
|           |           | > |       |
 ---             --- ---     ---     
|       |   |   |                   |
         ---     --- --- ---         
|   |                   |           |
         ---         ---     ---     
|   |           |         x |       |
 --- --- --- --- --- --- --- --- --- 