 --- --- --- --- --- --- --- --- --- 
|               |                 x |
     ---                 ---         
|           |           |   |       |
 ---             --- ---     ---     
|       | > |   |                   |
         ---     --- --- ---         
|   |                   |           |
         ---         ---     ---     
|   |           |           |       |
 --- --- --- --- --- --- --- --- --- 